Transaction Date,Description,Debit,Credit,Balance
2024-11-13,STARBUCKS,6.85,,14993.15
2024-11-12,TRANSFER TO WEALTHFRONT,800.00,,14193.15
2024-11-11,AMAZON.COM PURCHASE,134.56,,14058.59
2024-11-10,CHIPOTLE MEXICAN GRILL,12.45,,14046.14
2024-11-09,PG&E ELECTRIC BILL,89.23,,13956.91
2024-11-08,PAYROLL DEPOSIT,,3000.00,16956.91
2024-11-07,UBER RIDESHARE,18.75,,16938.16
2024-11-06,TARGET PURCHASE,67.89,,16870.27
